NO textures/art1.xpm
SO textures/art2.xpm
WE textures/art3.xpm
EA textures/art4.xpm


F 220,100,0
C 225,30,0


         11111111111111111111111
        1000000000110000000000001
        1011000001110000000000001
        1001000000000000000000001
111111111011000001110000000000001
100000000011000001110111101111111
11110111111111011100000010001
11110111111111011101010000001
11000000110101011100000010001
10000000000000000000000010001
10000100000000001101010010001
10000001110101011111011110N0111
11110111 1110101 101111010001
11111111 1111111 11111111111