NO textures/mossy.xpm
SO textures/purplestone.xpm
WE textures/redbrick.xpm
EA textures/wood.xpm


F 220,100,0
C 225,30,0


  111111111    11
  1       1 11100111
  1       1 11000011
  111111111 10000001
           10000001   1111111
           10000001
           100000011111111111111
           10000000000000000000011
           100N00000000000000000001
           10000000000000000000011
           100000011111111111111
           10000001
  111111111 10000001  11111111
  100000001 10000001
  100000001 11000011
  111111111 11100111
               11
