NO textures/mossy.xpm
SO textures/purplestone.xpm
WE textures/redbrick.xpm
EA textures/wood.xpm

C 0,255,0
F 0,0,255

              1   1
             1 1 1 1
            1   1   1
           1    1    1
                1
           1  11011  1
           1 1000001 1
             1010001
             1010101
             1000101
             1010001
             1010001
        111  1000001  111
       100011100V001110001
      1000001000000V1000001
     11000000000N00000000011
      10000000011100V000001
       11111111   11111111