NO textures/back1.xpm
SO textures/back1.xpm
WE textures/back1.xpm
EA textures/back1.xpm


F 220,100,0
C 225,30,0


              1   1
             1 1 1 1
            1   1   1
           1    1    1
                1
           1  11011  1
           1 1000001 1
             1010001
             1010101
             1000101
             1010001
             1010001
        111  1000001  111
       1000111000001110001
      100000100000001000001
     11000000000N00000000011
      100000000111000000001
       11111111   11111111