NO textures/mossy.xpm
SO textures/purplestone.xpm
WE textures/redbrick.xpm
EA textures/wood.xpm


C 0,255,0
F 0,0,255


              1   1
             1 1 1 1
            1   1   1
           1    1    1
                1
           1  11011  1
           1 1000001 1
             1010001
             1010101
             1000101
             101V001
             1010001
        111  1000001  111
       100011111C111110001
      10000010C000C01000001
     11000000010N01000000011
      10000000011100BBBB001
       11111111   11111111