NO textures/mossy.xpm
SO textures/purplestone.xpm
WE textures/redbrick.xpm
EA textures/wood.xpm


C 0,255,0
F 0,0,255


              1   1
             1 1 1 1
            1   1   1
           1    1    1
                1
           1  11011  1   1
           1 1000001 1  101
             1010001    1C1
             10101V1    101
             1000101    1C1
             1010001    101
             1010001    1C1
        111  1000001  111001
    11 100011111C111110001C01
   1CC10000010C000C01000001C01
   1011000000010N01000000011C1
   1C01000000001C1000000001C01
    1C01111111110111111111001
     1C0C0C0C0C0C0C0C0C0C0C1
      111111111111111111111